0 0 0 1 1 1 1 0 0 0
0 0 0 6 2 0 2 0 0 0
0 0 0 0 0 3 0 3 0 0
0 0 0 0 6 6 0 0 0 0
0 0 0 0 3 0 6 6 0 0
0 0 0 0 0 1 6 6 0 0
0 0 0 0 1 1 2 0 0 0
0 0 0 1 2 1 2 0 0 0 