6666266666
0000500066
6663266066
0005000000
6062636606
6066250006
6000002600
6660662606